1 6-0-0-0-0-0-0-0 0-1-0-0-0-0-0-0

2 3-3-0-0-0-0-0-0 1-0-0-0-0-0-0-0

3 2-2-2-0-0-0-0-0 0-0-1-0-0-0-0-0

4 1-1-2-2-0-0-0-0 0-0-0-1-0-0-0-0

5 0-4-3-0-0-0-0-0 1-0-0-0-0-0-0-0-0

BONUS STAGE [Valcoms]

6 0-2-3-2-0-0-0-0 1-0-0-0-0-0-0-0

7 0-2-3-0-2-0-0-0 0-1-0-0-0-0-0-0

8 0-1-2-4-0-0-0-0 0-0-1-0-0-0-0-0

9 1-1-4-0-1-0-0-0 0-0-0-0-1-0-0-0

10 1-1-1-1-3-0-0-0 0-0-0-0-0-1-0-0

BONUS STAGE [O'Neals]

11 1-2-3-1-1-0-0-0 1-0-0-0-0-0-0-0

12 1-1-1-1-4-0-0-0 1-0-0-0-0-0-0-0

13 3-3-2-0-0-0-0-0 0-0-1-0-0-0-0-0

14 0-1-7-0-0-0-1-0 0-0-0-0-1-0-0-0

15 1-3-3-0-0-0-0-1 0-1-0-0-0-0-0-0

BONUS STAGE [Dahls]

16 0-0-3-0-0-4-1-0 0-0-0-0-0-1-0-0

17 0-0-5-2-0-0-1-0 1-0-0-0-0-0-0-0

18 3-3-0-0-0-0-2-0 0-0-0-0-1-0-0-0

19 1-1-1-0-3-0-2-0 1-0-0-0-0-0-0-0

20 0-1-1-1-1-2-2-0 0-0-1-0-0-0-0-0

BONUS STAGE [Minvos]

21 0-0-0-0-3-4-2-0 0-0-0-0-1-0-0-0

22 4-3-10-0-0-0-1-0 0-0-0-0-1-0-0-0

23 0-0-2-2-2-2-1-0 1-0-0-0-0-0-0-0

24 0-0-1-1-2-4-1-0 0-0-0-0-1-0-0-0

25 0-0-2-1-2-2-1-0 0-0-0-0-1-0-0-0

BONUS STAGE [Ovapes]

26 1-1-1-1-1-2-2-0 0-0-0-0-0-0-1-0

27 0-1-1-1-5-0-1-0 0-1-0-0-0-0-0-0

28 0-0-1-3-3-1-1-0 1-0-0-0-0-0-0-0

29 0-0-0-0-5-2-2-0 0-0-0-0-1-0-0-0

30 0-0-3-2-2-1-1-0 0-0-0-0-0-0-0-1

BONUS STAGE [Dorias]

31 0-2-2-2-2-2-0-0 0-0-0-0-0-1-0-0

32 0-0-1-1-3-4-1-0 1-0-0-0-0-0-0-0

33 0-0-2-2-1-3-2-0 0-0-0-0-1-0-0-0

34 0-0-0-2-3-3-2-0 0-0-0-0-0-0-1-0 

35 0-0-2-1-1-3-2-0 0-0-0-0-1-0-0-0

BONUS STAGE [Passes]

36 0-0-0-2-2-3-3-0 0-0-0-0-0-0-0-1

37 0-0-2-1-1-3-3-0 0-0-0-0-1-0-0-0

38 0-0-2-2-3-3-0-0 0-1-0-0-0-0-0-0

39 0-0-1-1-2-2-4-0 0-0-0-0-0-0-0-1

BONUS STAGE [Pontans]

40 0-0-0-1-2-3-4-0 0-0-0-0-0-0-1-0

41 0-0-1-1-1-3-4-0 0-0-0-0-1-0-0-0

42 0-0-0-1-1-3-5-0 0-0-0-0-0-1-0-0

43 0-0-0-1-1-2-6-0 0-0-0-0-1-0-0-0

44 0-0-0-1-1-2-6-0 0-0-0-0-1-0-0-0

BONUS STAGE [Pontans]

45 0-0-0-0-2-2-6-0 0-0-0-0-0-0-1-0

46 0-0-0-0-2-2-6-0 0-0-0-0-0-1-0-0

47 0-0-0-0-2-2-6-0 0-0-0-0-1-0-0-0

48 0-0-0-0-1-2-6-1 0-0-0-0-1-0-0-0

49 0-0-0-0-2-1-6-1 0-0-0-0-0-0-0-1

BONUS STAGE [Pontans]

50 0-0-0-0-2-1-5-2 0-0-0-0-0-0-1-0